Raesfeld -	Raesfeld (a town in North Rhine-Westphalia, Germany)
Flughafen -	Airport
Berlin -	Berlin (capital city of Germany)
Bratwurst -	(Grilled) sausage
Hauptstraße -	Main street
Brot -	Bread
Klimaanlage -	Air conditioning
Rammstein -	Rammstein (German industrial metal band)
Porsche -	Porsche (German car manufacturer)
BMW -	BMW (German car manufacturer)
Biergarten -	Beer garden
Ratskeller -	“Councillors’ cellar” (a restaurant in a town-hall basement)
Dirndl -	Traditional Bavarian women’s dress
Lederhose -	Leather trousers (traditional Bavarian men’s garment)
Schloss -	Castle / palace
wettbewerbsfähig -	Competitive
Mehlhase -	(literally “flour hare” – rare/colloquial; maybe a novice baker covered in flour)
Gebäck -	Pastries / baked goods
Bäckerei	 -Bakery
Hund -	Dog
Döner	Döner - kebab (spit-roast sandwich)
Apfelkuchen -	Apple cake
Schloss Eltz -	Eltz Castle (medieval castle on the Moselle River)
